{
    "Background" : "Background.png",
	"Width" : 16,
	"Height" : 16,
	"TileSize" : 50,
	"Terrain" : 
	[
		2,2,2,2,2,2,2,2,2,2,2,2,2,2,2,2,
		2,0,0,0,0,0,0,0,0,0,0,0,0,0,0,2,
		2,0,0,0,0,0,3,0,0,3,0,0,0,0,0,2,
		2,3,3,3,3,3,3,0,0,3,3,3,3,3,3,2,
		2,0,0,0,0,0,3,0,0,3,0,0,0,0,0,2,
		2,0,0,0,0,0,0,0,0,0,0,0,0,0,0,2,
		2,0,0,0,0,0,0,0,0,0,0,0,0,0,0,2,
		1,1,1,1,1,1,1,1,1,0,0,0,0,0,0,2,
		2,0,0,0,0,0,0,1,1,1,1,1,1,1,1,1,
		2,0,0,0,0,0,0,0,0,0,0,0,0,0,0,2,
		2,0,0,0,0,0,0,0,0,0,0,0,0,0,0,2,
		2,0,0,0,0,0,3,0,0,3,0,0,0,0,0,2,
		2,3,3,3,3,3,3,0,0,3,3,3,3,3,3,2,
		2,0,0,0,0,0,3,0,0,3,0,0,0,0,0,2,
		2,0,0,0,0,0,0,0,0,0,0,0,0,0,0,2,
		2,2,2,2,2,2,2,2,2,2,2,2,2,2,2,2	
	],
	"Objects" : 
	[
		0,0,0,0,0,0,0,0,0,0,0,0,0,0,0,0,
		0,1,0,0,0,0,0,0,0,0,0,0,0,0,0,0,
		0,0,0,0,0,0,0,0,0,0,0,0,0,0,0,0,
		0,0,0,0,0,2,0,0,0,0,0,0,0,0,0,0,
		0,0,0,0,0,0,0,0,0,0,0,0,0,0,0,0,
		0,0,0,0,0,0,0,0,0,0,0,0,0,0,0,0,
		0,0,0,0,0,0,0,0,0,0,0,0,0,0,0,0,
		0,0,0,0,0,0,0,0,0,0,0,0,0,0,0,0,
		0,0,0,0,0,0,0,0,0,0,0,0,0,0,0,0,
		0,0,0,0,0,0,0,0,0,2,0,0,0,0,0,0,
		0,0,0,0,0,0,0,0,0,0,0,0,0,0,0,0,
		0,0,0,2,0,0,0,0,0,0,0,0,0,0,0,0,
		0,0,0,0,0,0,0,0,0,0,0,0,0,0,0,0,
		0,0,0,0,0,0,0,0,0,0,0,0,0,0,0,0,
		0,0,0,0,0,0,0,0,0,0,0,0,0,0,1,0,
		0,0,0,0,0,0,0,0,0,0,0,0,0,0,0,0	
	]
}
