{
    "Background" : "Background.png",
	"Width" : 30,
	"Height" : 20,
	"TileSize" : 50,
	"Terrain" : 
	[
		3,3,3,3,3,3,2,2,2,2,2,2,2,4,4,4,4,2,2,2,2,2,2,2,3,3,3,3,3,3,
		3,1,1,1,1,0,2,3,3,3,3,3,3,4,4,4,4,3,3,3,3,3,3,2,0,1,1,1,1,3,
		3,1,0,0,1,6,2,3,0,3,3,0,3,4,4,4,4,3,0,3,3,0,3,2,6,1,0,0,1,3,
		3,1,0,0,1,0,2,3,6,6,6,6,3,4,4,4,4,3,6,6,6,6,3,2,0,1,0,0,1,3,
		3,1,1,1,1,0,2,3,6,6,0,6,3,3,3,3,3,3,6,0,6,6,3,2,0,1,1,1,1,3,
		3,0,0,0,1,0,1,6,0,6,6,6,6,0,6,6,0,6,6,6,6,0,6,1,0,1,0,0,0,3,
		3,1,1,1,1,6,2,3,6,6,6,6,6,6,6,6,6,6,6,6,6,6,3,2,6,1,1,1,1,3,
		3,1,6,6,6,6,2,3,3,3,6,6,0,6,6,6,6,0,6,6,3,3,3,2,6,6,6,6,1,3,
		3,1,6,6,6,6,2,2,2,3,0,6,6,6,6,6,6,6,6,0,3,2,2,2,6,6,6,6,1,3,
		3,1,6,6,6,6,0,0,2,3,6,6,6,6,6,6,6,6,6,6,3,2,0,0,6,6,6,6,1,3,
		3,1,1,1,0,0,0,0,2,3,6,0,6,6,6,6,6,6,0,6,3,2,0,0,0,0,1,1,1,3,
		3,0,6,0,0,0,0,6,2,3,6,6,6,3,0,0,3,6,6,6,3,2,6,0,0,0,0,6,0,3,
		3,0,6,0,6,6,0,0,2,3,6,6,6,3,0,0,3,6,6,6,3,2,0,0,6,6,0,6,0,3,
		3,0,0,0,0,0,0,0,2,3,0,6,6,3,0,0,3,6,6,0,3,2,0,0,0,0,0,0,0,3,
		3,0,0,0,0,0,0,0,2,3,3,3,3,3,0,0,3,3,3,3,3,2,0,0,0,0,0,0,0,3,
		3,1,1,0,0,0,0,6,2,2,2,2,2,2,1,1,2,2,2,2,2,2,6,0,0,0,0,1,1,3,
		3,0,1,6,0,0,6,0,0,0,0,6,1,1,1,1,1,1,6,0,0,0,0,6,0,0,6,1,0,3,
		3,6,1,1,1,6,0,0,0,6,0,0,1,6,6,6,6,1,0,0,6,0,0,0,6,1,1,1,6,3,
		3,0,6,0,1,0,0,6,0,0,0,1,1,6,6,6,6,1,1,0,0,0,6,0,0,1,0,6,0,3,
		3,3,3,3,3,3,3,3,3,3,3,3,6,6,6,6,6,6,3,3,3,3,3,3,3,3,3,3,3,3
    ],
	"Objects" : 
	[
		0,0,0,0,0,0,0,0,0,0,0,0,0,0,0,0,0,0,0,0,0,0,0,0,0,0,0,0,0,0,
		0,0,0,0,0,0,0,0,0,0,0,0,0,0,0,0,0,0,0,0,0,0,0,0,0,0,0,0,0,0,
		0,0,1,0,0,0,0,0,0,0,0,2,0,0,0,0,0,0,2,0,0,0,0,0,0,0,0,1,0,0,
		0,0,0,0,0,0,0,0,0,0,0,0,0,0,0,0,0,0,0,0,0,0,0,0,0,0,0,0,0,0,
		0,0,0,0,0,0,0,0,0,0,0,0,0,0,0,0,0,0,0,0,0,0,0,0,0,0,0,0,0,0,
		0,0,0,0,0,0,0,0,0,0,0,0,0,2,0,0,2,0,0,0,0,0,0,0,0,0,0,0,0,0,
		0,0,0,0,0,0,0,0,0,0,0,0,0,0,0,0,0,0,0,0,0,0,0,0,0,0,0,0,0,0,
		0,0,0,0,0,0,0,0,0,0,0,0,0,0,0,0,0,0,0,0,0,0,0,0,0,0,0,0,0,0,
		0,0,0,0,0,0,0,0,0,0,2,0,0,0,0,0,0,0,0,2,0,0,0,0,0,0,0,0,0,0,
		0,0,0,0,0,0,0,0,0,0,0,0,0,0,0,0,0,0,0,0,0,0,0,0,0,0,0,0,0,0,
		0,0,0,2,0,0,0,0,0,0,0,0,0,0,0,0,0,0,0,0,0,0,0,0,0,0,2,0,0,0,
		0,0,0,0,0,0,0,0,0,0,0,0,0,0,0,0,0,0,0,0,0,0,0,0,0,0,0,0,0,0,
		0,0,0,0,0,0,0,0,0,0,0,0,0,0,0,0,0,0,0,0,0,0,0,0,0,0,0,0,0,0,
		0,0,0,0,0,0,0,0,0,0,2,0,0,0,0,0,0,0,0,2,0,0,0,0,0,0,0,0,0,0,
		0,0,0,0,0,0,0,0,0,0,0,0,0,0,0,0,0,0,0,0,0,0,0,0,0,0,0,0,0,0,
		0,0,0,0,0,0,0,0,0,0,0,0,0,0,1,2,0,0,0,0,0,0,0,0,0,0,0,0,0,0,
		0,0,0,0,0,0,0,0,0,0,0,0,0,0,0,0,0,0,0,0,0,0,0,0,0,0,0,0,0,0,
		0,0,0,0,0,0,0,0,2,0,0,0,0,0,0,0,0,0,0,0,0,2,0,0,0,0,0,0,0,0,
		0,0,0,0,0,0,0,0,0,0,0,0,0,0,0,0,0,0,0,0,0,0,0,0,0,0,0,0,0,0,
		0,2,0,0,0,0,0,0,0,0,2,0,0,0,0,0,0,0,0,2,0,0,0,0,0,0,0,0,2,0,
		0,0,0,0,0,0,0,0,0,0,0,0,0,0,0,0,0,0,0,0,0,0,0,0,0,0,0,0,0,0
	]
}
