{
    "Background" : "Background.png",
	"Width" : 30,
	"Height" : 20,
	"TileSize" : 50,
	"Terrain" : 
	[
		0,3,0,0,0,1,1,1,1,1,1,1,1,1,1,1,1,1,1,1,1,1,1,1,1,0,0,0,3,0,
		3,0,0,0,0,1,2,2,2,2,2,2,2,2,1,2,2,2,2,2,2,2,2,2,1,0,0,0,0,3,
		0,0,0,6,0,1,2,6,6,0,0,6,6,0,0,6,6,0,0,6,6,0,0,2,1,0,6,0,0,0,
		0,0,0,0,0,1,2,6,6,0,0,6,6,0,3,6,6,0,0,6,6,0,0,2,1,0,0,0,0,0,
		0,0,6,0,0,1,2,0,0,6,6,0,0,6,6,3,0,6,6,0,0,6,6,2,1,0,0,6,0,0,
		0,0,0,0,3,1,2,0,0,6,6,0,0,6,3,0,0,6,6,0,0,6,6,2,1,3,0,0,0,0,
		3,0,0,3,0,1,2,6,6,0,0,6,6,0,0,3,6,0,0,6,6,0,0,2,1,0,3,0,0,0,
		0,3,3,6,6,1,2,6,6,0,0,6,6,0,3,6,6,0,0,6,6,0,0,2,1,0,0,3,0,3,
		0,0,0,6,6,1,2,0,0,6,6,0,0,6,6,3,0,6,6,0,0,6,6,2,1,6,6,6,3,0,
		1,1,1,1,1,1,1,0,0,6,6,0,0,6,3,0,0,6,6,0,0,6,6,2,1,6,6,0,6,0,
		0,6,0,6,6,1,2,6,6,0,0,6,6,0,0,3,6,0,0,6,6,0,0,1,1,1,1,1,1,1,
		0,3,6,6,6,1,2,6,6,0,0,6,6,0,3,6,6,0,0,6,6,0,0,2,1,6,6,0,0,0,
		3,0,3,0,0,1,2,0,0,6,6,0,0,6,6,3,0,6,6,0,0,6,6,2,1,6,6,3,3,0,
		0,0,0,3,0,1,2,0,0,6,6,0,0,6,3,0,0,6,6,0,0,6,6,2,1,0,3,0,0,3,
		0,0,0,0,3,1,2,6,6,0,0,6,6,0,0,3,6,0,0,6,6,0,0,2,1,3,0,0,0,0,
		0,0,6,0,0,1,2,6,6,0,0,6,6,0,3,6,6,0,0,6,6,0,0,2,1,0,0,6,0,0,
		0,0,0,0,0,1,2,0,0,6,6,0,0,6,6,3,0,6,6,0,0,6,6,2,1,0,0,0,0,0,
		0,0,0,6,0,1,2,0,0,6,6,0,0,6,6,0,0,6,6,0,0,6,6,2,1,0,6,0,0,0,
		3,0,0,0,0,1,2,2,2,2,2,2,2,2,2,1,2,2,2,2,2,2,2,2,1,0,0,0,0,3,
		0,3,0,0,0,1,1,1,1,1,1,1,1,1,1,1,1,1,1,1,1,1,1,1,1,0,0,0,3,0
    ],
	"Objects" : 
	[
		2,0,0,0,0,2,0,0,0,0,0,0,0,0,0,0,0,0,0,0,0,0,0,0,2,0,0,0,0,2,
		0,0,0,0,0,0,0,0,0,0,0,0,0,0,0,0,0,0,0,0,0,0,0,0,0,0,0,0,0,0,
		0,0,0,0,0,0,0,0,0,0,0,0,0,0,2,0,0,0,0,0,0,0,0,0,0,0,0,0,0,0,
		0,0,0,0,0,0,0,0,0,0,0,0,0,0,0,0,0,0,0,0,0,0,0,0,0,0,0,0,0,0,
		0,0,0,0,0,0,0,0,0,0,0,0,0,0,0,0,0,0,0,0,0,0,0,0,0,0,0,0,0,0,
		0,0,0,0,0,0,0,0,0,0,0,0,0,0,0,0,0,0,0,0,0,0,0,0,0,0,0,0,0,0,
		0,0,0,0,0,0,0,0,0,0,0,0,0,0,0,0,0,0,0,0,0,0,0,0,0,0,0,0,0,0,
		0,0,0,0,0,0,0,0,0,0,0,0,0,0,0,0,0,0,0,0,0,0,0,0,0,0,0,0,0,0,
		0,0,2,0,0,0,0,0,0,0,0,0,0,0,0,0,0,0,0,0,0,0,0,0,0,0,0,0,0,0,
		0,1,0,0,0,2,0,0,0,0,0,0,0,0,0,2,0,0,0,0,0,0,0,0,0,0,0,2,0,0,
		0,0,2,0,0,0,0,0,0,0,0,0,0,0,2,0,0,0,0,0,0,0,0,0,2,0,0,0,1,0,
		0,0,0,0,0,0,0,0,0,0,0,0,0,0,0,0,0,0,0,0,0,0,0,0,0,0,0,2,0,0,
		0,0,0,0,0,0,0,0,0,0,0,0,0,0,0,0,0,0,0,0,0,0,0,0,0,0,0,0,0,0,
		0,0,0,0,0,0,0,0,0,0,0,0,0,0,0,0,0,0,0,0,0,0,0,0,0,0,0,0,0,0,
		0,0,0,0,0,0,0,0,0,0,0,0,0,0,0,0,0,0,0,0,0,0,0,0,0,0,0,0,0,0,
		0,0,0,0,0,0,0,0,0,0,0,0,0,0,0,0,0,0,0,0,0,0,0,0,0,0,0,0,0,0,
		0,0,0,0,0,0,0,0,0,0,0,0,0,0,0,0,0,0,0,0,0,0,0,0,0,0,0,0,0,0,
		0,0,0,0,0,0,0,0,0,0,0,0,0,0,0,2,0,0,0,0,0,0,0,0,0,0,0,0,0,0,
		0,0,0,0,0,0,0,0,0,0,0,0,0,0,0,0,0,0,0,0,0,0,0,0,0,0,0,0,0,0,
		2,0,0,0,0,2,0,0,0,0,0,0,0,0,0,0,0,0,0,0,0,0,0,0,2,0,0,0,0,2
	]
}
